9
22
S.......++++++++.....+
.+.++++++........+++.+
.+.++++++.++++++.+++.+
...++++++..+++++.+++.+
.++++........+++.+++++
......+++++...+.....++
.+++++++++++++.++++.++
......+++++F........++
++++++++++++++++++++++
