9
14
++++++++++++++
+S++++......++
+.++...+++++++
+.++...+++...+
+.++...+++...+
+.+++F.......+
+.++++++++++.+
+............+
++++++++++++++

